11111111111111111111
10000000010000100011
10101111110000100001
11100100010000100001
10000100010000000001
10000100010001000001
10000001111111000001
10000001000000000001
10000001000001000001
10000000000001000001
11111111111111000001
10000000000000000001
10000000000000000001
10000110000000000111
10000000000000011001
10000000000001100111
10001111100000011011
10000000100001101111
10000000100110011001
11111111111111111111
