111111111111111111111111
100000000000000000000001
111001111110011111100111
100000000000010000000001
100011100111110011111101
100000000000100000000001
110011111110100011111101
100000000011011000000101
100000000000000000000111
111110011111111110000001
100000000000000001111101
100000000000011111111111
100010001000000000000001
100010001000000000000001
100010001000000000000001
111111111111111111111111
