1111111111111
1000000000011
1000000000001
1001010101001
1000000000001
1001010101001
1000000000001
1001010101001
1000000000001
1100000000011
1111111111111
